                  
      


NO         ./textures/wall.xpm42       



SO ./textures/ruby.xpm42


WE ./textures/box3.xpm42
EA       ./textures/door.xpm42        


C    225,30,0
F         220   ,100   ,   0




111111111111111111111111111111111
100000000000000000000000000000001
100000000000000000000000000000001
100000000000000000000000000000001
100000000000000000000000000000001
101000000000000E00000000000000001
100000000000000000000000000000001
100000000000000000000000000000001
100000000000000000000000000000001
100000000000000000000000000000001
111111111111111111111111111111111