                  
      


NO         ./textures/wall.xpm42       



SO ./textures/ruby.xpm42


WE ./textures/box3.xpm42
EA       ./textures/door.xpm42        


C    225,30,0
F         220   ,100   ,   0




111111111111111111111111111111111
10000000001100000000000001
10110000011100000000000001
100100000000000000000001111
1111111110110000011100000001
100000000011000001110111111111111
11110111111111011100000010001
11110111111111011101010010001
11000000110101011100000010001
1000000000N000011000000100001
10000000000000001101010010001
110000011101010111110111100111
11110111 1110101 101111010001
11111111 1111111 111111111111