

NO ./textures/box.xpm42     
SO ./textures/ruby.xpm42
WE ./textures/blue.xpm42
EA ./textures/door.xpm42        


F 190,178,123
C 135,206,235

1111111111111111111111111111111111111111
1000000000000000000000000000000000000001
1000000000000000000000000000000000000001
1000000000000000000000000000000000000001
1000000000000000001000000000000000000001
1000000000000000000000000000000000000001
1000000000100000000N00000001000000000001
1000000000000000000000000000000000000001
1000000000000000000000000000000000000001
1000000000000000000000000000000000000001
1000000000000000000000000000000000000001
1111111111111111111111111111111111111111